00000000000000000
00000000000000000
22000000000000022
22000000000000022
11111100000111111
00000000000000000
00000000000000000
00001111111110000
11000000000000011
00000000000000000
00000000100000000
11111100000111111
22000000000000022
22000000000000022
11111111111111111
