000000000000000000000000
000000000000000000000000
000000000000000000000000
000000000000000000000000
111111111111111111111111
000030000000000000000000
000030000000000000000000
000030000000000000000000
000030000000000000000000
000030000000000000000000
111111111111111111111111
000000000000000000000000
000000000000000000000000
000000000000000000000000
000000000000000000000000
