00000000000111110000000000000000000001111100000000000
00000000001000001000000000000000000010000010000000000
00000000010000000100000000000000000130000001000000000
00000000100000000010000000000000001030000000100000000
11111111000011100001000000000000010030111000011111111
00000000000100010000100000000000100031000100004000000
00000000001000001000010000000001000010000010004000000
00000000010000000100001000000010000100000001004000000
00000000100000000010000100000100001000000000104000000
00000001000000000001000010001000010000000000014000000
11111110000000000000100001110000100000000000001111111
00000000000000000000010000000001000000000000000000000
00000000000000000000001000000010000000000000000000000
00000000000000000000000100000100000000000000000000000
00000000000000000000000011111000000000000000000000000
