00000000000000000000000000000000000000000000000000000
00000000000000000000000000000001110000000000000000000
00000000000000001110000000001110001110000000000000000
00000000000001110001110001110000000000000000000000000
11111110001110000000001110000000000000000000001111111
00000001110000000000000030000000000000000000004000000
00000000000000000000000030000000000000000000004000000
00000000000000000000000030000000000000111111104000000
00000000000000000000000030000000000000000000004000000
00000001110000000000000030000000000000000000004000000
11111110001110000000001110000000000000000000001111111
00000000000001110001110001110000000000000000000000000
00000000000000001110000000001110001110000000000000000
00000000000000000000000000000001110000000000000000000
00000000000000000000000000000000000000000000000000000
