00000000000000000000000000000000000000000000000000000
00000000000001110000000000000000000000000000000000000
00000000111110000000011111111000001111111111100000000
00000000000000000000000003000000000000000000000000000
11111110000000000000000003000000000000000000001111111
00000000000000000111110003001111100000000000004000000
00000000000000000000000003000000000000000000004000000
00000000000000000000000003000000000000000000004000000
00000000000000000000000003000000000000000000004000000
00000000000000000111110003001111100000000000004000000
11111110000000000000000003000000000000000000001111111
00000000000000000000000003000000000000000000000000000
00000000111110000000011111111000001111111111100000000
00000000000001110000000000000000000000000000000000000
00000000000000000000000000000000000000000000000000000
