00000000000
00000000000
00000000000
00000000000
11111111111
00000500001
00000500001
00000500001
00000500001
00000500001
11111111111
00000000000
00000000000
00000000000
00000000000
