00000000000001110000000000000003000000000000000000000
00000000000000000000000000000003000000000000000000000
00000000000000000000000000000003000000000000000000000
00000000000000000000000000000003000000000000000000000
11111110000000000000001111100003011111111111111111111
00000000000000000000000000000003000010000010000010000
00000000000000000000000000000003000010000010000010000
00000001110000000111110000011113000000000000000040000
00000000000000000000000000000003000000010000010040000
00000000000000000000000000000003000000010000010040000
11111110000000000000001111100003011111111111111111111
00000000000000000000000000000003000000000000000000000
00000000000000000000000000000003000000000000000000000
00000000000000000000000000000003000000000000000000000
00000000000001110000000000000003000000000000000000000
