0000000000000000000000000000000000000000000000000000000000000000000000000
0000000000000000000000000000000000000000000000000000000000000000000000000
0000000000000000000000000000000000000000000000000000000000000000000000000
0000000000000000000000000000000000000000000000000000000000000000000000000
1111111000000000000000000000000000000000000000000000000000000000001111111
0000000111111111111111111111111111111111111111111111111111111111110000000
0000000000100000100000100000100000100000100000100000100000100000100000000
0000000000000000000000000000000000000000000000000000300000000000400000000
0000000000000100000100000100000100000100000100000100300100000100400000000
0000000111111111111111111111111111111111111111111111111111111111110000000
1111111000000000000000000000000000000000000000000000000000000000001111111
0000000000000000000000000000000000000000000000000000000000000000000000000
0000000000000000000000000000000000000000000000000000000000000000000000000
0000000000000000000000000000000000000000000000000000000000000000000000000
0000000000000000000000000000000000000000000000000000000000000000000000000
