00000000000000000000000000000000000000000000000000000
00000000000000000000000000000000000000000000000000000
00000000000000000000000000000000000000000000000000000
00000001111111111111111111111111111111111111111111000
11111110000100000001000000010003000100000001000000111
00000000000100000001000000010003000100000001000000400
00000000000000000000000000000003000000000000000000400
00000000000000000000000000000003000000000000000000400
00000000000000000000000000000003000000000000000000400
00000000000000010000000100000001000000010000000100400
11111110000000010000000100000001000000010000000100111
00000001111111111111111111111111111111111111111111000
00000000000000000000000000000000000000000000000000000
00000000000000000000000000000000000000000000000000000
00000000000000000000000000000000000000000000000000000
